"station_id","longitude","latitude","numtrips.start","numtrips.stop","netflow","use","zip","adi_state_rank","adi_national_rank","food_min_dist","food_500","bus_min_dist","bus_500"
"ch100",-87.63639,41.888243,16771,18630,1859,35401,60602,5.94736842105263,68.2105263157895,79.6533790439579,361,219.978559836318,2
"ch101",-87.57612,41.781016,1068,1058,-10,2126,60649,5.21428571428571,60.7142857142857,850.526192426898,0,2473.42247449552,0
"ch102",-87.58534,41.773458,374,387,13,761,60649,5.21428571428571,60.7142857142857,93.471878936229,11,1867.80219923922,0
"ch103",-87.640949065,41.87146676,1902,2739,837,4641,60402,6.59090909090909,72.0909090909091,64.6718340456191,36,452.31636556131,2
"ch106",-87.628722,41.897448,11203,10799,-404,22002,60611,5.82352941176471,67.2352941176471,29.5289746819637,384,97.4732759327921,2
"ch107",-87.643909,41.878287,9304,9081,-223,18385,60402,6.59090909090909,72.0909090909091,67.9097721771651,187,390.019492671922,2
"ch108",-87.64664,41.87184,7337,7422,85,14759,60607,5.33333333333333,62.2777777777778,47.8690606340573,5,477.223397265445,2
"ch109",-87.650019,41.874675,4813,4426,-387,9239,60607,5.33333333333333,62.2777777777778,232.683161216973,52,92.4477743678808,2
"ch11",-87.57645,41.766638,247,216,-31,463,60619,5.35714285714286,62.5714285714286,92.7213607502645,26,2878.14214391268,0
"ch110",-87.629318,41.893992,21772,22348,576,44120,60611,5.82352941176471,67.2352941176471,20.1430786907827,598,279.98000922533,4
"ch111",-87.638437,41.894666,10025,10062,37,20087,60654,5.86666666666667,68.1333333333333,24.0396634486282,195,735.30938303292,0
"ch112",-87.64867,41.883668,13003,14694,1691,27697,60606,5.61111111111111,64.7222222222222,13.52331863734,323,361.783274771368,2
"ch113",-87.65222,41.91844,11818,13104,1286,24922,60614,5.82352941176471,67.2352941176471,17.0033942348769,128,43.0195930842205,2
"ch114",-87.654242,41.946966,15421,18016,2595,33437,60618,5.4,63.3333333333333,7.30307676221445,213,72.4034196319123,2
"ch115",-87.653566,41.936253,12916,13107,191,26023,60613,5.82352941176471,67.1176470588235,15.8665818184772,190,34.8730308864904,8
"ch116",-87.687051,41.915533,7614,7369,-245,14983,60647,5.1875,60.125,21.7752149864252,85,74.0131921336671,2
"ch117",-87.65304,41.94018,18387,19479,1092,37866,60613,5.82352941176471,67.1176470588235,33.3175579699384,272,55.3670960806776,6
"ch118",-87.638677,41.911386,11266,10524,-742,21790,60610,5.625,63.9375,15.0229285177758,111,120.269474097951,2
"ch119",-87.66732,41.88541,4903,4923,20,9826,60622,6.125,69.9375,19.4502418584881,38,33.0754514778406,2
"ch12",-87.565688,41.766409,684,631,-53,1315,60619,5.35714285714286,62.5714285714286,56.2169082844239,30,3679.38346155106,0
"ch120",-87.631886,41.853605,5303,6104,801,11407,60616,5.82352941176471,67.1764705882353,48.096465021881,218,88.1772023875477,4
"ch121",-87.590368,41.802562,2259,2094,-165,4353,60615,5.76470588235294,67,62.6747339544747,102,2464.41079601871,0
"ch122",-87.67328,41.87501,2901,2520,-381,5421,60612,5.82352941176471,67.1176470588235,141.022130499839,30,94.3690543819676,4
"ch123",-87.697153,41.922695,8858,8974,116,17832,60625,5.25,62,11.7667732238011,97,86.7580135669105,2
"ch124",-87.675726,41.855048,1688,1935,247,3623,60608,5.33333333333333,62.3333333333333,39.3753392433993,51,62.4978290296882,2
"ch125",-87.626293,41.890011,11229,14047,2818,25276,60601,5.94736842105263,68.2105263157895,42.0939371712902,736,233.059165582653,2
"ch126",-87.631942,41.911974,11426,11510,84,22936,60610,5.625,63.9375,102.356106775149,126,634.888400390016,0
"ch127",-87.64926,41.925905,9489,9308,-181,18797,60614,5.82352941176471,67.2352941176471,17.7300672248554,153,313.788525092014,4
"ch128",-87.67722,41.895769,10416,11088,672,21504,60622,6.125,69.9375,9.06171796527937,81,1225.50096683484,0
"ch129",-87.661535,41.857556,5107,5172,65,10279,606,5.76190476190476,64.1904761904762,26.3102019467429,99,633.270837279566,0
"ch13",-87.652705,41.932418,12672,13014,342,25686,60613,5.82352941176471,67.1176470588235,14.4990665970909,123,49.6457785533705,4
"ch130",-87.67695,41.90331,10838,10647,-191,21485,60622,6.125,69.9375,24.7521479276229,125,715.775288128159,0
"ch131",-87.668385,41.939365,6230,6407,177,12637,60657,5.35714285714286,63,23.6892373076935,99,517.123860938216,0
"ch132",-87.631715,41.849237,1337,1625,288,2962,60616,5.82352941176471,67.1764705882353,23.5962147507788,131,445.181588099239,2
"ch133",-87.638506,41.889177,31100,31240,140,62340,60602,5.94736842105263,68.2105263157895,109.6297944906,210,380.981908245674,4
"ch134",-87.649633,41.877749,14441,14474,33,28915,60607,5.33333333333333,62.2777777777778,5.58438274660877,80,252.760925018986,2
"ch135",-87.64665,41.85378,1217,1252,35,2469,60608,5.33333333333333,62.3333333333333,8.99291515847933,18,1303.80134577394,0
"ch136",-87.656959,41.865054,741,790,49,1531,60608,5.33333333333333,62.3333333333333,476.770869816728,12,1268.84774317752,0
"ch137",-87.651062,41.862378,4232,4078,-154,8310,60608,5.33333333333333,62.3333333333333,419.594917665945,35,1458.92583782999,0
"ch138",-87.640552,41.904613,6047,5886,-161,11933,60610,5.625,63.9375,13.5719210828786,28,652.071086129103,0
"ch14",-87.651073,41.858086,3604,3931,327,7535,60608,5.33333333333333,62.3333333333333,13.6679471349328,40,1500.89952962441,0
"ch140",-87.629912,41.898969,16705,17757,1052,34462,60611,5.82352941176471,67.2352941176471,132.918283405152,299,293.089296253273,2
"ch141",-87.6346,41.915689,20600,20476,-124,41076,60610,5.625,63.9375,31.8927153192639,61,704.348262957625,0
"ch142",-87.617854,41.894503,14262,14223,-39,28485,60611,5.82352941176471,67.2352941176471,49.1074386439794,267,889.785837035992,0
"ch143",-87.638888,41.922167,12147,11291,-856,23438,60614,5.82352941176471,67.2352941176471,28.4685769610228,103,1202.90787847716,0
"ch144",-87.64414,41.921822,12602,12169,-433,24771,60614,5.82352941176471,67.2352941176471,13.4079857978753,105,807.804626108473,0
"ch145",-87.621915,41.898587,13788,13010,-778,26798,60611,5.82352941176471,67.2352941176471,13.0369076021817,305,561.454333074575,0
"ch146",-87.662007,41.877945,5185,4958,-227,10143,60607,5.33333333333333,62.2777777777778,222.237478754868,38,911.805997657807,0
"ch147",-87.62248,41.8457,1934,1884,-50,3818,60616,5.82352941176471,67.1764705882353,265.817176783354,12,885.651900757859,0
"ch148",-87.625813,41.834734,4614,4970,356,9584,60616,5.82352941176471,67.1764705882353,187.92790091197,16,339.542847339767,2
"ch149",-87.61793,41.8349,3037,2738,-299,5775,60616,5.82352941176471,67.1764705882353,184.3523630368,31,747.225677725934,0
"ch15",-87.656495,41.858166,3955,4003,48,7958,60608,5.33333333333333,62.3333333333333,20.1262474315856,65,1050.94522848953,0
"ch150",-87.608218,41.838556,10639,11001,362,21640,60616,5.82352941176471,67.1764705882353,47.703457994686,2,1650.1398836749,0
"ch152",-87.658617,41.932225,8723,8328,-395,17051,60613,5.82352941176471,67.1176470588235,47.6025769436136,75,458.47106853482,2
"ch153",-87.663576,41.935733,11888,11497,-391,23385,60657,5.35714285714286,63,22.4259838575488,109,855.69733757047,0
"ch154",-87.66378,41.93949,5934,5750,-184,11684,60657,5.35714285714286,63,10.6068208587223,97,472.689516219607,2
"ch156",-87.647539,41.936497,12650,12739,89,25389,60614,5.82352941176471,67.2352941176471,41.7150832302106,298,477.747455473646,2
"ch157",-87.636794,41.936669,13500,13912,412,27412,60614,5.82352941176471,67.2352941176471,56.5364777184341,16,1367.90216242661,0
"ch158",-87.681391,41.912616,7969,8097,128,16066,60647,5.1875,60.125,13.7721531055874,162,457.57436541116,2
"ch159",-87.685854,41.907781,3057,3043,-14,6100,60647,5.1875,60.125,120.465192383996,44,731.59514587169,0
"ch16",-87.670072,41.910337,7058,6884,-174,13942,60622,6.125,69.9375,64.4719069482499,127,614.594103985829,0
"ch160",-87.689556,41.910535,3141,3163,22,6304,60647,5.1875,60.125,51.8903058717063,48,650.386228535034,0
"ch161",-87.625908,41.895765,12038,11242,-796,23280,60611,5.82352941176471,67.2352941176471,18.7705442190263,616,213.423803446748,4
"ch162",-87.67842,41.93588,3958,4373,415,8331,60646,5.4375,63.875,338.495149705588,10,1061.99742242665,0
"ch163",-87.677856,41.931931,3386,3659,273,7045,60646,5.4375,63.875,105.970858594222,7,1420.77963208174,0
"ch164",-87.6355,41.885837,13624,12825,-799,26449,60602,5.94736842105263,68.2105263157895,24.1936087220433,470,371.653261310373,8
"ch165",-87.659172,41.95078,6440,5981,-459,12421,60618,5.4,63.3333333333333,29.8995802885423,126,484.175453553866,4
"ch166",-87.668507,41.92883,4913,5052,139,9965,60657,5.35714285714286,63,18.0847613833576,72,1346.92615369148,0
"ch167",-87.67564,41.8492,386,400,14,786,60608,5.33333333333333,62.3333333333333,49.7040463903651,35,591.21623011376,0
"ch168",-87.623727,41.864059,8502,8599,97,17101,60605,5.61111111111111,64.7222222222222,18.140720177452,97,441.156768145073,4
"ch169",-87.639566,41.874337,3410,3074,-336,6484,60402,6.59090909090909,72.0909090909091,31.5176746368116,90,177.989637642128,2
"ch17",-87.67273,41.90332,7396,7568,172,14964,60622,6.125,69.9375,12.827574168788,165,517.287184799918,0
"ch170",-87.640826,41.85795,2854,2951,97,5805,60608,5.33333333333333,62.3333333333333,47.8524082161574,11,973.513033659334,0
"ch171",-87.654127,41.855136,1163,1131,-32,2294,60608,5.33333333333333,62.3333333333333,187.454288807307,48,1284.65068223916,0
"ch172",-87.627691,41.902309,10464,10541,77,21005,60611,5.82352941176471,67.2352941176471,21.2250932728435,246,627.512092849706,0
"ch173",-87.621743,41.89691,13946,14735,789,28681,60611,5.82352941176471,67.2352941176471,16.271777628245,411,534.498948176298,0
"ch174",-87.639833,41.882091,36064,39590,3526,75654,60602,5.94736842105263,68.2105263157895,12.3821659311759,471,430.001482607697,2
"ch175",-87.633523,41.872373,9319,7363,-1956,16682,60605,5.61111111111111,64.7222222222222,35.7349746473143,80,385.079712933694,2
"ch176",-87.631253,41.903233,20231,20364,133,40595,60611,5.82352941176471,67.2352941176471,49.9861097199089,187,772.279943994428,0
"ch177",-87.630834,41.926277,47927,51281,3354,99208,60614,5.82352941176471,67.2352941176471,17.7202431041083,8,1832.55733123256,0
"ch178",-87.627542,41.856594,3190,3275,85,6465,60605,5.61111111111111,64.7222222222222,21.6945707974376,103,397.840680589253,4
"ch179",-87.61615,41.82256,702,688,-14,1390,60637,5.5,63.375,55.3163778799219,3,443.408247496179,2
"ch18",-87.637313,41.883272,14240,13839,-401,28079,60602,5.94736842105263,68.2105263157895,26.8144537102084,559,300.168798700816,4
"ch180",-87.626402,41.906782,7592,7089,-503,14681,60611,5.82352941176471,67.2352941176471,208.495248017803,55,1132.64894638341,0
"ch181",-87.63206,41.890749,20365,21559,1194,41924,60602,5.94736842105263,68.2105263157895,31.0925099824443,587,251.037760670122,4
"ch182",-87.634324,41.903222,11878,11869,-9,23747,60611,5.82352941176471,67.2352941176471,16.675299176627,154,888.656262027826,0
"ch183",-87.677234,41.899714,7295,7202,-93,14497,60622,6.125,69.9375,14.4459070453522,132,978.502831998441,0
"ch184",-87.62688,41.83104,2116,2465,349,4581,60616,5.82352941176471,67.1764705882353,12.3844549439804,21,112.568412700968,4
"ch185",-87.691392,41.917741,2440,2337,-103,4777,60647,5.1875,60.125,11.5165603228334,85,377.643418526079,2
"ch186",-87.658751,41.891795,6513,6386,-127,12899,60642,5.82352941176471,67.1176470588235,12.4675095711374,68,558.7040201944,0
"ch188",-87.6658,41.92533,5482,6021,539,11503,60614,5.82352941176471,67.2352941176471,33.0609840401534,112,1073.29342144789,0
"ch19",-87.660996,41.869417,6230,6478,248,12708,60607,5.33333333333333,62.2777777777778,25.4703819627993,74,747.077803031452,0
"ch190",-87.663913,41.928773,7812,7509,-303,15321,60657,5.35714285714286,63,42.3663859074117,70,996.531624256343,0
"ch191",-87.639525,41.880884,17451,12889,-4562,30340,60602,5.94736842105263,68.2105263157895,26.3964193670317,463,517.546384840935,0
"ch192",-87.639904,41.879255,33390,30492,-2898,63882,60602,5.94736842105263,68.2105263157895,35.5393728031166,331,422.363665716906,2
"ch193",-87.626938,41.841707,666,659,-7,1325,60616,5.82352941176471,67.1764705882353,413.567526959283,8,1117.85571201904,0
"ch194",-87.62603,41.886875,13187,13529,342,26716,60601,5.94736842105263,68.2105263157895,43.9300216752727,611,273.052786836117,6
"ch195",-87.619521,41.884728,28118,19623,-8495,47741,60601,5.94736842105263,68.2105263157895,24.9274727402516,193,688.295366571544,0
"ch196",-87.622072,41.890573,11507,11073,-434,22580,60601,5.94736842105263,68.2105263157895,51.3279397406361,508,508.398623028328,0
"ch197",-87.625125,41.882134,11563,11742,179,23305,60601,5.94736842105263,68.2105263157895,15.9985023692905,548,263.330497424539,12
"ch198",-87.648789,41.881892,15573,16335,762,31908,60606,5.61111111111111,64.7222222222222,85.1777274380177,272,498.1667772716,2
"ch199",-87.626937,41.891738,23379,24432,1053,47811,60611,5.82352941176471,67.2352941176471,6.02588384953326,709,90.3269984145467,2
"ch2",-87.623975,41.8726525,13294,12423,-871,25717,60605,5.61111111111111,64.7222222222222,34.2264822587676,149,329.134363885408,2
"ch20",-87.653106,41.910522,9642,10758,1116,20400,60622,6.125,69.9375,13.139736598465,93,326.310494935566,2
"ch200",-87.616279,41.809851,456,362,-94,818,60628,4.875,58.6875,34.483487117246,31,223.3381860225,2
"ch201",-87.6216,41.82168,370,336,-34,706,60653,5.86666666666667,68.1333333333333,248.668365435846,11,19.8830321789113,2
"ch202",-87.646277,41.857499,2770,2395,-375,5165,60608,5.33333333333333,62.3333333333333,21.5659563027799,27,1357.71503914639,0
"ch203",-87.685243,41.85394,1089,1213,124,2302,60608,5.33333333333333,62.3333333333333,24.8791937449519,37,33.0402672766591,2
"ch204",-87.618691,41.794853,1593,1524,-69,3117,60621,6.125,69.9375,61.9816000351034,9,46.5906043308946,2
"ch205",-87.668745,41.857901,3359,3226,-133,6585,60608,5.33333333333333,62.3333333333333,31.9660468397128,86,33.3890542770376,2
"ch206",-87.646795,41.847203,2543,2593,50,5136,60608,5.33333333333333,62.3333333333333,75.789033089627,21,1473.79726173441,0
"ch207",-87.645368,41.84358,1698,1562,-136,3260,60616,5.82352941176471,67.1764705882353,143.8266211693,18,1604.1307689577,0
"ch208",-87.665897,41.85381,1064,1190,126,2254,60608,5.33333333333333,62.3333333333333,168.822025096683,79,529.157484445041,0
"ch209",-87.640591,41.849527,1268,1190,-78,2458,60608,5.33333333333333,62.3333333333333,42.1438061785031,20,897.540218738353,0
"ch21",-87.654787,41.877726,9425,9457,32,18882,60607,5.33333333333333,62.2777777777778,120.51247282779,60,490.297570328536,2
"ch210",-87.667747,41.90345,15073,16583,1510,31656,60622,6.125,69.9375,23.6194970022084,125,104.337836644245,2
"ch211",-87.622663,41.894448,20463,24739,4276,45202,60611,5.82352941176471,67.2352941176471,21.8056528911636,539,519.878505886344,0
"ch212",-87.636928,41.892154,15466,15614,148,31080,60606,5.61111111111111,64.7222222222222,20.0397060198914,306,432.784722267616,2
"ch213",-87.68229,41.910153,5997,6218,221,12215,60647,5.1875,60.125,45.4182101045106,162,405.195769629107,2
"ch214",-87.67686,41.89122,5677,5529,-148,11206,60622,6.125,69.9375,81.6252444762519,14,1053.94116710481,0
"ch215",-87.67493,41.88137,2558,2442,-116,5000,60612,5.82352941176471,67.1176470588235,55.6067866042662,27,634.536702073128,0
"ch216",-87.697474,41.903029,2569,3093,524,5662,60302,6.71428571428571,72.75,37.3392299871116,40,1682.19733699316,0
"ch217",-87.656001,41.886773,8179,8255,76,16434,60622,6.125,69.9375,21.7494463288051,154,342.453450641898,2
"ch218",-87.633879,41.856802,1266,1062,-204,2328,60616,5.82352941176471,67.1764705882353,230.324025341931,143,466.860789431076,2
"ch219",-87.677411,41.916027,9063,8998,-65,18061,60647,5.1875,60.125,27.4605327097036,75,697.86614800009,0
"ch22",-87.655486,41.869482,6653,6607,-46,13260,60607,5.33333333333333,62.2777777777778,7.24622506255336,53,820.425463413764,0
"ch220",-87.642385,41.93262,13065,14130,1065,27195,60614,5.82352941176471,67.2352941176471,51.3856616303331,218,891.338937572333,0
"ch222",-87.693033,41.920195,2782,2628,-154,5410,60625,5.25,62,8.89962064909112,76,374.020361549322,2
"ch223",-87.656936,41.918216,8242,8513,271,16755,60642,5.82352941176471,67.1176470588235,6.04055978801144,79,356.050448566398,2
"ch224",-87.64884,41.913778,6978,6808,-170,13786,60614,5.82352941176471,67.2352941176471,27.6356998195656,91,348.001499800211,2
"ch225",-87.64883,41.919936,9749,9763,14,19512,60614,5.82352941176471,67.2352941176471,18.4375270146326,155,369.539671316454,2
"ch226",-87.658865,41.939743,7965,7946,-19,15911,60613,5.82352941176471,67.1176470588235,48.7758888166517,102,454.865742153597,4
"ch227",-87.66394,41.94815,10539,10313,-226,20852,60613,5.82352941176471,67.1176470588235,34.6892241283349,100,490.107593677596,2
"ch228",-87.6785,41.9406,3213,3174,-39,6387,60618,5.4,63.3333333333333,25.1815160625762,55,713.588488399882,0
"ch229",-87.66402,41.943739,11936,12426,490,24362,60613,5.82352941176471,67.1176470588235,18.2204866191061,85,33.2570403921648,2
"ch23",-87.637715,41.902924,4365,4234,-131,8599,60610,5.625,63.9375,121.572098746333,74,841.733104314861,0
"ch230",-87.67097,41.94334,9450,9993,543,19443,60613,5.82352941176471,67.1176470588235,26.9456531592118,66,31.8646019007618,2
"ch231",-87.65464,41.96167,8600,8972,372,17572,60640,5.26666666666667,61.2666666666667,17.494090405064,65,378.570710648821,4
"ch232",-87.646303,41.949275,10301,10293,-8,20594,60657,5.35714285714286,63,162.275812162969,64,640.92625177532,0
"ch233",-87.651148,41.883004,9029,8615,-414,17644,60607,5.33333333333333,62.2777777777778,79.2680258559401,311,299.614685711144,2
"ch234",-87.666036,41.961588,4308,4242,-66,8550,60613,5.82352941176471,67.1176470588235,7.13527077696827,42,747.249079594209,0
"ch236",-87.638517,41.907576,2522,2268,-254,4790,60610,5.625,63.9375,109.043624167138,122,321.33536671549,2
"ch237",-87.617,41.842052,5185,4980,-205,10165,60616,5.82352941176471,67.1764705882353,523.856532653238,0,1365.78180690146,0
"ch238",-87.674365,41.961615,4709,4306,-403,9015,60618,5.4,63.3333333333333,44.1327459932338,68,58.6671210757866,2
"ch239",-87.688487,41.966555,5301,5658,357,10959,60625,5.25,62,41.6024629481849,123,43.5582220430781,4
"ch24",-87.62062,41.89186,20462,20130,-332,40592,60601,5.94736842105263,68.2105263157895,23.8794184837916,457,614.598262333846,0
"ch240",-87.654406,41.954245,14237,15167,930,29404,60618,5.4,63.3333333333333,23.4992662069354,67,67.8640908045796,4
"ch241",-87.65103,41.871737,9969,9855,-114,19824,60607,5.33333333333333,62.2777777777778,203.989541365285,31,429.356195830477,2
"ch242",-87.679028,41.967094,5357,5135,-222,10492,60625,5.25,62,6.22733399553145,57,95.3638128101418,2
"ch243",-87.684146,41.962391,4999,5515,516,10514,60618,5.4,63.3333333333333,124.507192967787,91,553.105181675305,0
"ch244",-87.67393,41.95469,5091,5382,291,10473,60625,5.25,62,52.0011615568917,102,80.0025713740978,2
"ch245",-87.649603,41.961004,5922,5618,-304,11540,60640,5.26666666666667,61.2666666666667,186.819503743708,32,754.994623709123,0
"ch246",-87.668869,41.956061,3058,2755,-303,5813,60613,5.82352941176471,67.1176470588235,185.672741167813,45,525.961046430703,0
"ch247",-87.580715,41.795212,6692,6868,176,13560,60653,5.86666666666667,68.1333333333333,10.1940685839045,13,2666.03690746278,0
"ch248",-87.596471,41.795264,3224,2949,-275,6173,60637,5.5,63.375,14.6403151537955,48,1816.60911751454,0
"ch249",-87.638181,41.963982,15037,15331,294,30368,60640,5.26666666666667,61.2666666666667,38.6016394502939,1,1609.11213138511,0
"ch25",-87.62351,41.89766,12185,12015,-170,24200,60611,5.82352941176471,67.2352941176471,6.18572512294109,417,402.484062461059,2
"ch250",-87.669807,41.936083,4265,4711,446,8976,60657,5.35714285714286,63,93.623666914861,68,842.437189823911,0
"ch251",-87.650001,41.967968,4129,4096,-33,8225,60640,5.26666666666667,61.2666666666667,20.0362319792939,25,715.830611660888,0
"ch252",-87.599383,41.809835,1367,1259,-108,2626,60653,5.86666666666667,68.1333333333333,12.5184121855028,7,1617.15782973277,0
"ch253",-87.658857,41.968873,4395,4567,172,8962,60640,5.26666666666667,61.2666666666667,36.3709526895717,134,42.2290758550131,2
"ch254",-87.648043,41.954383,12142,11744,-398,23886,60613,5.82352941176471,67.1176470588235,127.640700925264,48,574.900521236779,0
"ch255",-87.623041,41.867888,24643,22609,-2034,47252,60605,5.61111111111111,64.7222222222222,101.947649623482,126,299.489914568799,4
"ch256",-87.649993,41.952833,7234,7129,-105,14363,60613,5.82352941176471,67.1176470588235,24.5592527872714,73,422.413551640881,4
"ch257",-87.675112,41.94911,4280,4508,228,8788,60625,5.25,62,47.6073060290296,38,234.513296457216,2
"ch258",-87.685126,41.930584,5024,5128,104,10152,60647,5.1875,60.125,40.7129344225012,29,1369.00081150209,0
"ch259",-87.696972,41.918121,3908,3382,-526,7290,60625,5.25,62,13.6117004099383,82,424.126420684234,2
"ch26",-87.6173,41.89102,25997,25750,-247,51747,60601,5.94736842105263,68.2105263157895,11.99844588925,256,892.632030956645,0
"ch260",-87.707857,41.929567,8691,8969,278,17660,60625,5.25,62,56.8897548363575,92,59.4839508918021,2
"ch261",-87.669886,41.871514,5034,4858,-176,9892,60607,5.33333333333333,62.2777777777778,5.43839161659435,29,29.8384835039725,2
"ch262",-87.64572,41.827059,452,453,1,905,60616,5.82352941176471,67.1764705882353,39.9533698840432,18,1334.45985808879,0
"ch263",-87.613533,41.836208,1976,1887,-89,3863,60616,5.82352941176471,67.1764705882353,413.275722258524,5,1138.40749457533,0
"ch264",-87.62232,41.886835,13090,10936,-2154,24026,60601,5.94736842105263,68.2105263157895,90.6173527784352,409,508.423189326905,0
"ch265",-87.6071,41.822985,1445,1538,93,2983,60637,5.5,63.375,575.096912601187,0,1193.78592893355,0
"ch267",-87.591875,41.809443,2810,3010,200,5820,60653,5.86666666666667,68.1333333333333,57.0193169396034,11,2239.71521233507,0
"ch268",-87.626804,41.911722,45754,50622,4868,96376,60611,5.82352941176471,67.2352941176471,242.185599949961,16,1047.11483080052,0
"ch27",-87.6435,41.91021,4587,4143,-444,8730,60614,5.82352941176471,67.2352941176471,73.0603832045396,59,348.99612485276,4
"ch270",-87.586883,41.75867,157,165,8,322,60649,5.21428571428571,60.7142857142857,24.2815390492327,22,2874.97193298463,0
"ch271",-87.606582,41.816499,497,539,42,1036,60637,5.5,63.375,25.2755581876162,28,1033.54465849856,0
"ch272",-87.621857,41.838842,2703,2778,75,5481,60616,5.82352941176471,67.1764705882353,71.0516671835323,5,861.402825984987,0
"ch273",-87.62455,41.857813,9139,9515,376,18654,60605,5.61111111111111,64.7222222222222,43.5265771147904,42,543.99906462893,0
"ch274",-87.656625,41.861267,2131,2267,136,4398,606,5.76190476190476,64.1904761904762,361.224379938793,46,1104.64551921064,0
"ch275",-87.666507,41.865234,1492,1705,213,3197,60608,5.33333333333333,62.3333333333333,5.92228461411686,23,745.169484315197,0
"ch276",-87.6972,41.91044,3280,3151,-129,6431,60647,5.1875,60.125,96.9656769201657,18,1033.98150988775,0
"ch277",-87.666611,41.891072,4091,4037,-54,8128,60622,6.125,69.9375,26.9624696084675,43,645.230149149715,0
"ch278",-87.64129,41.830629,1526,1431,-95,2957,60616,5.82352941176471,67.1764705882353,185.793462965247,26,887.223559632265,0
"ch279",-87.647172,41.830661,1295,1381,86,2676,60616,5.82352941176471,67.1764705882353,35.4689403920358,38,1374.90162614967,0
"ch28",-87.64332,41.91468,5839,5415,-424,11254,60614,5.82352941176471,67.2352941176471,370.827115010215,36,579.79726177254,0
"ch280",-87.65114,41.8378,2334,2253,-81,4587,60616,5.82352941176471,67.1764705882353,20.0448239997211,36,1188.26317960405,0
"ch281",-87.685109,41.84847,474,430,-44,904,60608,5.33333333333333,62.3333333333333,52.632476501802,46,639.212297657574,0
"ch282",-87.647071,41.864883,6959,6873,-86,13832,60616,5.82352941176471,67.1764705882353,10.2099884443769,49,1196.5326738606,0
"ch283",-87.631985,41.87817,23456,22333,-1123,45789,60602,5.94736842105263,68.2105263157895,17.2684369284428,549,158.098702455679,14
"ch284",-87.62408,41.87785,18584,18892,308,37476,60601,5.94736842105263,68.2105263157895,35.046063445401,313,245.481715092721,10
"ch285",-87.67203,41.89113,4367,4489,122,8856,60612,5.82352941176471,67.1176470588235,13.4301764333245,24,774.738304574372,0
"ch286",-87.634793,41.878724,17347,17770,423,35117,60602,5.94736842105263,68.2105263157895,40.3904560313073,505,87.4073803029428,8
"ch287",-87.635185,41.880317,26862,27119,257,53981,60602,5.94736842105263,68.2105263157895,39.6056226170367,633,213.851473971656,6
"ch288",-87.643749,41.918084,6996,6569,-427,13565,60614,5.82352941176471,67.2352941176471,177.064985952243,71,738.049031956315,0
"ch289",-87.634656,41.912133,22481,21856,-625,44337,60610,5.625,63.9375,43.4233887143689,146,430.402123221721,2
"ch29",-87.6626,41.90068,8358,8144,-214,16502,60622,6.125,69.9375,31.2471200976815,56,439.077063248596,2
"ch290",-87.707322,41.921525,4079,3879,-200,7958,60625,5.25,62,389.031578950864,45,866.578353480546,0
"ch291",-87.63483,41.906724,13835,13041,-794,26876,60611,5.82352941176471,67.2352941176471,23.9495219552339,150,552.444442516146,0
"ch292",-87.664199,41.957081,2766,2510,-256,5276,60613,5.82352941176471,67.1176470588235,283.996874417216,23,851.779206727176,0
"ch293",-87.657238,41.965485,4705,4955,250,9660,60613,5.82352941176471,67.1176470588235,35.4537190232347,123,137.71106610702,6
"ch294",-87.659753,41.978353,5993,6054,61,12047,60626,5.25,62,29.2358119695121,53,98.8237415631928,2
"ch295",-87.659637,41.972972,4557,4683,126,9240,60626,5.25,62,1.2126342640329,107,106.175230690401,4
"ch296",-87.645451,41.940106,10695,12173,1478,22868,60657,5.35714285714286,63,65.5464151339349,247,658.722379133306,0
"ch297",-87.671387,41.961507,2586,2209,-377,4795,60613,5.82352941176471,67.1176470588235,52.4723610074367,60,304.67377458206,2
"ch298",-87.679259,41.955927,5026,5324,298,10350,60625,5.25,62,71.9198109312888,108,396.134695980064,2
"ch299",-87.64895,41.94367,10600,10708,108,21308,60657,5.35714285714286,63,17.5846093932525,238,569.591927882598,0
"ch3",-87.615355,41.867226,28186,27358,-828,55544,60605,5.61111111111111,64.7222222222222,316.405241713563,10,932.971367551921,0
"ch30",-87.6677,41.899643,5170,4427,-743,9597,60622,6.125,69.9375,42.2359870675561,116,424.228675195003,2
"ch300",-87.644095,41.937725,13263,13816,553,27079,60614,5.82352941176471,67.2352941176471,31.4159219075741,220,783.449524288222,0
"ch301",-87.631501,41.907993,13671,11734,-1937,25405,60611,5.82352941176471,67.2352941176471,134.465085513483,170,700.661501822419,0
"ch302",-87.653833,41.928712,9000,8380,-620,17380,60614,5.82352941176471,67.2352941176471,17.0928921285482,126,414.469135069966,6
"ch303",-87.64598,41.945512,11882,11874,-8,23756,60657,5.35714285714286,63,18.9425744801658,115,668.771687526209,0
"ch304",-87.648674,41.949546,10140,10356,216,20496,60657,5.35714285714286,63,27.1462676160686,90,473.224856064856,2
"ch305",-87.687275,41.902893,5021,5023,2,10044,60622,6.125,69.9375,79.5638205434179,37,1115.95663903021,0
"ch306",-87.654966,41.958494,5953,5782,-171,11735,60613,5.82352941176471,67.1176470588235,120.042384977695,50,524.159782449553,0
"ch307",-87.663712,41.920771,6584,7348,764,13932,60642,5.82352941176471,67.1176470588235,52.4016692520909,68,960.971867943911,0
"ch308",-87.679618,41.943403,3875,4017,142,7892,60618,5.4,63.3333333333333,13.2249946925777,66,576.515984428729,0
"ch309",-87.682437,41.917805,4525,4290,-235,8815,60647,5.1875,60.125,33.3569011133469,108,447.851407749005,2
"ch31",-87.635638,41.896802,15124,14965,-159,30089,60611,5.82352941176471,67.2352941176471,14.0653840357379,213,619.401836547551,0
"ch310",-87.677855,41.920082,4274,4271,-3,8545,60647,5.1875,60.125,0.734733550160478,58,901.289017599257,0
"ch311",-87.684001,41.968885,3010,2840,-170,5850,60625,5.25,62,13.3109385905125,120,480.222408396249,2
"ch312",-87.649519,41.957879,8010,7815,-195,15825,60640,5.26666666666667,61.2666666666667,12.9544879101102,51,639.509669228319,0
"ch313",-87.638973,41.925858,14632,14711,79,29343,60614,5.82352941176471,67.2352941176471,43.2183052226111,114,1155.86881456921,0
"ch314",-87.673567,41.957921,3370,3187,-183,6557,60618,5.4,63.3333333333333,57.8245378185388,54,392.748098108071,4
"ch315",-87.664169,41.912919,2878,2858,-20,5736,60642,5.82352941176471,67.1176470588235,90.0562791027646,22,1079.69057926822,0
"ch316",-87.679258,41.96325,3446,3454,8,6900,60618,5.4,63.3333333333333,154.790543154368,87,341.098112577667,4
"ch317",-87.671045,41.869154,5380,5699,319,11079,60607,5.33333333333333,62.2777777777778,244.143844371718,14,294.450134339206,2
"ch318",-87.664358,41.954177,5957,5625,-332,11582,60613,5.82352941176471,67.1176470588235,24.730860198477,61,783.036605269509,0
"ch319",-87.665939,41.932595,3603,3782,179,7385,60657,5.35714285714286,63,163.745753080268,62,1062.37954189481,0
"ch32",-87.65703,41.87464,4403,4060,-343,8463,60607,5.33333333333333,62.2777777777778,124.529666967259,14,614.918828338855,0
"ch320",-87.661501,41.872187,6733,6392,-341,13125,60607,5.33333333333333,62.2777777777778,303.863480215707,66,670.274441474228,0
"ch321",-87.626106,41.871962,12836,12777,-59,25613,60605,5.61111111111111,64.7222222222222,27.9661812207968,184,257.315378276418,2
"ch322",-87.594747,41.799568,6067,6153,86,12220,60615,5.76470588235294,67,18.7514839845556,69,2019.71296408912,0
"ch323",-87.654691,41.969517,2514,2764,250,5278,60640,5.26666666666667,61.2666666666667,25.2510707009984,106,317.934252915567,2
"ch324",-87.638742,41.93132,8270,10044,1774,18314,60614,5.82352941176471,67.2352941176471,222.124106880723,93,1203.6686594887,0
"ch325",-87.668365,41.973385,7581,7312,-269,14893,60660,5,59,26.342288696896,58,815.211253747496,0
"ch326",-87.667429,41.967096,4982,4598,-384,9580,60640,5.26666666666667,61.2666666666667,25.9921876814751,47,774.703284130759,0
"ch327",-87.653818,41.92154,10628,11202,574,21830,60614,5.82352941176471,67.2352941176471,21.2340089461222,102,381.723706238795,6
"ch328",-87.601334,41.788746,4668,4826,158,9494,60637,5.5,63.375,58.9652784943322,59,1009.70803723792,0
"ch329",-87.63625,41.932684,11793,11928,135,23721,60614,5.82352941176471,67.2352941176471,40.8587883941537,27,1400.08641671628,0
"ch33",-87.627844,41.877181,13814,13695,-119,27509,60602,5.94736842105263,68.2105263157895,36.3511310855542,451,45.925828096132,16
"ch330",-87.673308,41.946176,2561,2591,30,5152,60625,5.25,62,36.8704859601479,51,145.572137986374,4
"ch331",-87.648627,41.908537,11445,12528,1083,23973,60614,5.82352941176471,67.2352941176471,56.1448661425907,99,239.634384493103,2
"ch332",-87.648959,41.933666,7836,8758,922,16594,60614,5.82352941176471,67.2352941176471,54.8465383841978,247,361.231761415086,4
"ch333",-87.667252,41.907066,5939,5918,-21,11857,60642,5.82352941176471,67.1176470588235,16.221647368145,97,416.931901298104,2
"ch334",-87.639192,41.940775,16378,16610,232,32988,60657,5.35714285714286,63,119.565546976612,73,1182.06998634514,0
"ch335",-87.618034,41.831379,693,677,-16,1370,60616,5.82352941176471,67.1764705882353,44.3971647455215,39,648.118885696038,0
"ch336",-87.606755,41.809855,872,960,88,1832,60653,5.86666666666667,68.1333333333333,52.6311934944119,18,1005.63131410865,0
"ch337",-87.630931,41.896544,10727,9636,-1091,20363,60611,5.82352941176471,67.2352941176471,25.7078974517387,328,229.057728106958,2
"ch338",-87.619407,41.857611,8585,8370,-215,16955,60605,5.61111111111111,64.7222222222222,224.105710360026,23,766.003819553448,0
"ch339",-87.645143,41.838198,2732,2871,139,5603,60616,5.82352941176471,67.1764705882353,33.9203696830251,42,1434.49586474889,0
"ch34",-87.634429,41.926756,9021,9338,317,18359,60614,5.82352941176471,67.2352941176471,286.232860445752,17,1540.9713296273,0
"ch340",-87.643118,41.929546,14623,14643,20,29266,60614,5.82352941176471,67.2352941176471,8.21235234304841,216,902.73040173903,0
"ch341",-87.607267,41.866095,21552,21481,-71,43033,60605,5.61111111111111,64.7222222222222,250.475807347744,2,1610.84570987712,0
"ch342",-87.673688,41.871262,8416,7892,-524,16308,60612,5.82352941176471,67.1176470588235,67.3357683897606,12,346.675460757768,4
"ch343",-87.658971,41.928887,5580,5143,-437,10723,60613,5.82352941176471,67.1176470588235,49.7288593997061,71,645.760506195694,0
"ch344",-87.674237,41.96909,12750,13521,771,26271,60640,5.26666666666667,61.2666666666667,51.9233800166055,53,479.736338005446,2
"ch345",-87.587782,41.793242,4864,4887,23,9751,NA,5.65194094747947,65.2719986419663,176.911881798953,25,2078.69310102854,0
"ch346",-87.661206,41.88283,8480,8705,225,17185,60622,6.125,69.9375,129.965244675468,71,549.720080404209,0
"ch347",-87.6687,41.950687,4667,4339,-328,9006,60613,5.82352941176471,67.1176470588235,10.7822214376956,75,638.685020287759,0
"ch348",-87.695445,41.854016,803,971,168,1774,60608,5.33333333333333,62.3333333333333,27.2178396321603,52,56.6690838253208,2
"ch349",-87.649077,41.929143,10422,9842,-580,20264,60614,5.82352941176471,67.2352941176471,12.4727919956984,199,521.506380895448,0
"ch35",-87.612043,41.892278,90042,99495,9453,189537,60601,5.94736842105263,68.2105263157895,44.2574876241611,114,1327.77297384984,0
"ch350",-87.667747,41.895966,6402,6466,64,12868,60625,5.25,62,29.9983989919482,99,827.245309749421,0
"ch351",-87.606615,41.803038,557,506,-51,1063,90615,5.53333333333333,63,19.6707130683679,7,1224.54733456979,0
"ch352",-87.577143,41.773518,571,562,-9,1133,60619,5.35714285714286,62.5714285714286,68.5849560166231,1,2503.59146158708,0
"ch353",-87.674367,42.01256,556,576,20,1132,60645,5.375,63.6875,9.99318350792964,78,571.468754067751,0
"ch354",-87.662412,42.010587,1869,1991,122,3860,60645,5.375,63.6875,178.46237395987,43,380.782714227659,2
"ch355",-87.567339,41.773669,779,800,21,1579,60619,5.35714285714286,62.5714285714286,525.910662061309,0,3286.18893187611,0
"ch356",-87.586461,41.766493,325,314,-11,639,60649,5.21428571428571,60.7142857142857,19.1547906111232,16,2226.08486568966,0
"ch359",-87.643353,41.903486,8171,7616,-555,15787,60610,5.625,63.9375,258.395895879704,22,839.199254311845,0
"ch36",-87.635321,41.877708,24758,21944,-2814,46702,60602,5.94736842105263,68.2105263157895,33.4257942217351,399,173.010550078616,4
"ch364",-87.642985,41.900219,7463,7829,366,15292,60610,5.625,63.9375,162.659716876424,49,1072.95590539171,0
"ch365",-87.64848,41.899368,2280,2149,-131,4429,60622,6.125,69.9375,55.1925566114313,20,667.867407170027,0
"ch366",-87.657435,41.841633,1057,917,-140,1974,60608,5.33333333333333,62.3333333333333,37.0681660544371,12,706.807918094273,0
"ch367",-87.655976,41.830696,602,644,42,1246,60620,5.64285714285714,64.7857142857143,14.002476131914,13,1225.28900337448,0
"ch368",-87.66561,41.839209,435,410,-25,845,60609,5.3125,61.0625,215.780017568606,17,24.49418499592,2
"ch369",-87.670298,41.830105,275,266,-9,541,60620,5.64285714285714,64.7857142857143,205.317692659184,22,861.685378621402,0
"ch37",-87.629791,41.879356,16798,15464,-1334,32262,60602,5.94736842105263,68.2105263157895,27.7678769804652,653,136.611822219037,20
"ch370",-87.619154,41.854184,3558,3671,113,7229,60616,5.82352941176471,67.1764705882353,128.958526574303,56,613.476114511416,0
"ch372",-87.702882,41.900146,1743,1829,86,3572,60622,6.125,69.9375,289.280180705785,4,1778.56584932362,0
"ch373",-87.706128,41.895465,848,1019,171,1867,60622,6.125,69.9375,32.3214725544143,16,1237.77887930044,0
"ch374",-87.686596,41.898418,5121,5078,-43,10199,60622,6.125,69.9375,35.1893349700915,54,1469.72907662696,0
"ch375",-87.70103,41.889727,237,209,-28,446,60622,6.125,69.9375,255.594234354017,6,735.847837175185,0
"ch376",-87.688219,41.889492,5604,4097,-1507,9701,60622,6.125,69.9375,32.7044279467212,6,1556.65323271169,0
"ch377",-87.706304,41.884603,1084,1120,36,2204,60622,6.125,69.9375,171.138832517117,13,33.6751270435725,2
"ch378",-87.696298,41.884454,735,714,-21,1449,60622,6.125,69.9375,34.7058210933832,12,818.269888981886,0
"ch38",-87.630876,41.886021,14770,14391,-379,29161,60602,5.94736842105263,68.2105263157895,28.0071654661731,732,31.5551006910512,12
"ch381",-87.686113,41.879788,904,1096,192,2000,60612,5.82352941176471,67.1176470588235,94.2183616557595,22,516.093288938354,0
"ch382",-87.686445,41.874749,1668,1626,-42,3294,60612,5.82352941176471,67.1176470588235,48.335478386173,16,184.046376592629,2
"ch383",-87.667246,41.874291,5716,5713,-3,11429,60607,5.33333333333333,62.2777777777778,23.2950906370627,22,358.56671155034,2
"ch384",-87.645214,41.801832,26,21,-5,47,60609,5.3125,61.0625,32.3287010648251,7,1515.06900371536,0
"ch385",-87.633124,41.794982,270,253,-17,523,60621,6.125,69.9375,80.7843767495931,15,1230.04921404438,0
"ch386",-87.64499,41.79293,30,33,3,63,60621,6.125,69.9375,159.305892620057,17,1554.7611316113,0
"ch388",-87.644621,41.779381,120,118,-2,238,60621,6.125,69.9375,31.1678222385877,26,57.8705603286517,2
"ch39",-87.625689,41.879472,11615,11650,35,23265,60601,5.94736842105263,68.2105263157895,22.183778801357,453,29.1468129092844,12
"ch390",-87.629746,41.78008,125,75,-50,200,60621,6.125,69.9375,3.39945186151483,2,112.327322061634,2
"ch391",-87.644614,41.769062,15,24,9,39,60621,6.125,69.9375,35.4186375773869,15,1097.90284403231,0
"ch392",-87.628196,41.769293,77,74,-3,151,60621,6.125,69.9375,116.034430804746,6,229.842334050525,2
"ch393",-87.616918,41.765508,34,35,1,69,60619,5.35714285714286,62.5714285714286,135.154205754544,25,798.12943153317,0
"ch394",-87.631246,41.870816,4447,4376,-71,8823,60605,5.61111111111111,64.7222222222222,155.198330057231,77,475.336967006949,4
"ch395",-87.575839,41.75712,118,107,-11,225,60649,5.21428571428571,60.7142857142857,54.9909133745228,8,3586.58569416963,0
"ch396",-87.56644,41.758768,84,85,1,169,60619,5.35714285714286,62.5714285714286,16.3540175919771,8,4057.84747493091,0
"ch397",-87.560115,41.758746,119,102,-17,221,NA,5.65194094747947,65.2719986419663,42.6305476097454,7,4494.6405239415,0
"ch398",-87.549386,41.757871,88,96,8,184,NA,5.65194094747947,65.2719986419663,714.725111442635,0,5315.91781149761,0
"ch399",-87.559275,41.762189,394,407,13,801,60619,5.35714285714286,62.5714285714286,245.328668662106,6,4364.82334539627,0
"ch4",-87.613348,41.856268,19906,20290,384,40196,60616,5.82352941176471,67.1764705882353,574.57336027932,0,1139.15754679878,0
"ch40",-87.631985,41.879344,10771,10268,-503,21039,60602,5.94736842105263,68.2105263157895,28.4278190650828,612,161.182132087626,20
"ch400",-87.60496,41.765719,196,194,-2,390,60619,5.35714285714286,62.5714285714286,51.8909352022466,7,1622.21024900085,0
"ch401",-87.635491,41.842733,1261,1240,-21,2501,60616,5.82352941176471,67.1764705882353,308.420832972987,14,1222.38300867612,0
"ch402",-87.635406,41.838464,1752,1686,-66,3438,60616,5.82352941176471,67.1764705882353,43.0839981853365,42,899.750189210684,0
"ch403",-87.631823,41.83453,2110,2120,10,4230,60616,5.82352941176471,67.1764705882353,51.9652914958531,38,383.746500021043,2
"ch405",-87.632504,41.830777,716,643,-73,1359,60616,5.82352941176471,67.1764705882353,203.359999904976,27,161.8438539991,2
"ch406",-87.608799,41.831274,555,535,-20,1090,60616,5.82352941176471,67.1764705882353,489.600191515396,2,1415.12405908465,0
"ch407",-87.626568,41.823015,77,77,0,154,60616,5.82352941176471,67.1764705882353,210.98366856528,10,454.679003256741,2
"ch408",-87.643565,41.817638,100,139,39,239,60616,5.82352941176471,67.1764705882353,253.951299568521,5,1327.20963827432,0
"ch409",-87.634819,41.816208,88,59,-29,147,60609,5.3125,61.0625,296.796092911521,6,729.29117808534,0
"ch41",-87.629544,41.872078,12354,12082,-272,24436,60605,5.61111111111111,64.7222222222222,10.2488884250157,176,277.178939454207,4
"ch410",-87.619412,41.816659,390,422,32,812,60653,5.86666666666667,68.1333333333333,32.2788855196006,9,39.1689360794713,2
"ch411",-87.645617,41.808134,315,365,50,680,60609,5.3125,61.0625,103.236212272812,8,1243.51536772272,0
"ch412",-87.633449,41.809318,220,163,-57,383,60609,5.3125,61.0625,50.522529595871,9,236.230165771664,2
"ch413",-87.597005,41.814093,925,954,29,1879,60653,5.86666666666667,68.1333333333333,402.448426342338,4,1848.13498011175,0
"ch414",-87.639474,41.870257,5561,5238,-323,10799,60402,6.59090909090909,72.0909090909091,77.0947185417775,43,599.918526282052,0
"ch415",-87.618054,41.802295,485,488,3,973,60628,4.875,58.6875,76.7905139325938,28,770.609776525644,0
"ch416",-87.592464,41.805772,1013,911,-102,1924,60615,5.76470588235294,67,446.269404111343,16,2223.69502069208,0
"ch417",-87.586924,41.802406,5007,4892,-115,9899,60615,5.76470588235294,67,31.9843314788447,90,2730.81931969843,0
"ch418",-87.600958,41.799336,3048,2898,-150,5946,60615,5.76470588235294,67,16.3258711722289,13,1515.87024767588,0
"ch419",-87.58645,41.799494,3939,4088,149,8027,NA,5.65194094747947,65.2719986419663,5.38913551326174,112,2672.61489962601,0
"ch42",-87.626488,41.852619,2543,2806,263,5349,60616,5.82352941176471,67.1764705882353,42.1003718530971,116,55.5518910834137,4
"ch420",-87.60145,41.794301,4982,4827,-155,9809,60637,5.5,63.375,40.7142158510274,41,1406.08891382021,0
"ch421",-87.61585313,41.79342923,171,159,-12,330,60621,6.125,69.9375,225.972054562735,5,282.397883596724,2
"ch422",-87.607852,41.791568,855,786,-69,1641,90615,5.53333333333333,63,154.176630748797,26,958.274654533049,0
"ch423",-87.599861,41.791478,7944,8169,225,16113,60637,5.5,63.375,30.3453696869069,65,1336.91989031996,0
"ch424",-87.583945,41.791728,4136,4038,-98,8174,NA,5.65194094747947,65.2719986419663,215.139725936843,22,2219.5553241462,0
"ch425",-87.588315,41.787943,1885,1542,-343,3427,60649,5.21428571428571,60.7142857142857,210.206657865611,11,1686.85741782203,0
"ch426",-87.601073,41.785097,4095,4279,184,8374,60637,5.5,63.375,8.28051364820315,23,664.061771733686,0
"ch427",-87.606112,41.780599,518,550,32,1068,60637,5.5,63.375,27.3979642394523,14,38.5603438454006,2
"ch428",-87.591416,41.780406,578,575,-3,1153,60649,5.21428571428571,60.7142857142857,295.270934870228,6,1200.60178689201,0
"ch429",-87.605635,41.773721,183,170,-13,353,60637,5.5,63.375,28.8029601331088,15,731.955021188933,0
"ch43",-87.624649,41.883893,26010,27394,1384,53404,60601,5.94736842105263,68.2105263157895,70.4251534255638,555,281.633306684803,6
"ch430",-87.615943,41.780081,167,169,2,336,60628,4.875,58.6875,43.3399795500719,21,838.884679903584,0
"ch431",-87.613308,41.784142,126,144,18,270,90615,5.53333333333333,63,7.85746166290835,10,751.61620089927,0
"ch432",-87.673711,42.009069,2049,2227,178,4276,60645,5.375,63.6875,10.0515681585966,76,651.066694693795,0
"ch433",-87.704871,41.8736,257,241,-16,498,60624,5.4375,63.9375,223.680719317493,13,127.244995637917,2
"ch434",-87.684697,41.866501,1803,1906,103,3709,60629,5,58.8125,63.0308466198035,54,1044.28151213499,0
"ch435",-87.706496,41.866493,913,922,9,1835,60629,5,58.8125,63.3398573689007,15,872.505038414784,0
"ch436",-87.694521,41.866624,562,544,-18,1106,60629,5,58.8125,120.386308778421,7,1105.57964112765,0
"ch437",-87.693374,41.86148,690,811,121,1501,60629,5,58.8125,269.02963042613,1,826.912849889865,0
"ch438",-87.715406,41.854204,275,190,-85,465,60652,5.86666666666667,68.1333333333333,188.802568066887,3,61.9436648417623,2
"ch439",-87.705073,41.853534,376,250,-126,626,60623,5.70588235294118,65.8823529411765,198.412028210787,32,55.2712635062595,2
"ch44",-87.627734,41.88473,16631,16379,-252,33010,60601,5.94736842105263,68.2105263157895,22.9807624875051,664,10.9539100776151,12
"ch440",-87.717,41.849882,21,26,5,47,60652,5.86666666666667,68.1333333333333,408.217546690075,6,474.636678598148,2
"ch441",-87.705414,41.848191,149,213,64,362,60623,5.70588235294118,65.8823529411765,172.773072597583,62,641.209570443776,0
"ch442",-87.69514,41.84911,673,559,-114,1232,60623,5.70588235294118,65.8823529411765,282.577398969368,51,556.072194177676,0
"ch443",-87.71591,41.844567,154,244,90,398,60623,5.70588235294118,65.8823529411765,28.57633190067,49,1033.65654760177,0
"ch444",-87.702013,41.844475,146,157,11,303,60623,5.70588235294118,65.8823529411765,14.2571251249826,43,1091.00614342853,0
"ch445",-87.695296,41.84404,183,171,-12,354,60623,5.70588235294118,65.8823529411765,77.2769530829761,13,1119.20724580436,0
"ch446",-87.685131,41.841518,180,208,28,388,60608,5.33333333333333,62.3333333333333,51.4811608976474,7,1402.11643155478,0
"ch447",-87.665502,42.007972,3038,3231,193,6269,60645,5.375,63.6875,19.0996806259796,64,54.8932593641386,2
"ch448",-87.680666,42.00455,516,486,-30,1002,60645,5.375,63.6875,262.22987053014,2,1293.75279334129,0
"ch449",-87.672402,42.004451,1682,1499,-183,3181,60645,5.375,63.6875,44.7400240468812,51,691.406202973205,0
"ch45",-87.624426,41.876243,11230,10329,-901,21559,60602,5.94736842105263,68.2105263157895,0.80280411840099,261,320.413600165503,10
"ch450",-87.689726,42.002007,538,581,43,1119,60645,5.375,63.6875,246.141366292184,30,2095.55810315142,0
"ch451",-87.661198,42.001044,3890,3776,-114,7666,606226,5.65194094747947,65.2719986419663,32.9496605419379,98,11.7985789399351,2
"ch452",-87.689438,41.994161,670,726,56,1396,60645,5.375,63.6875,61.3975064245033,108,2473.31739919988,0
"ch453",-87.671377,41.999252,1583,1665,82,3248,606226,5.65194094747947,65.2719986419663,112.998716373646,54,878.293543958118,0
"ch454",-87.660285,41.99478,4252,4560,308,8812,606226,5.65194094747947,65.2719986419663,22.9824213656419,101,153.029277345869,2
"ch455",-87.69337,41.990236,495,629,134,1124,60645,5.375,63.6875,19.7410533629732,28,2679.87149272099,0
"ch456",-87.683593,41.991178,500,507,7,1007,60660,5,59,352.93457257904,2,2034.11008530868,0
"ch457",-87.669583,41.990894,2271,2056,-215,4327,606226,5.65194094747947,65.2719986419663,24.7225838114377,23,873.493610157575,0
"ch458",-87.660141,41.989743,4269,4697,428,8966,606226,5.65194094747947,65.2719986419663,40.6280368199218,56,105.227857325148,4
"ch459",-87.65231,41.984037,10763,10917,154,21680,60626,5.25,62,234.186533470723,21,544.381622564481,0
"ch46",-87.63443,41.89993,8704,6858,-1846,15562,60611,5.82352941176471,67.2352941176471,44.5030367847837,147,632.742745915525,0
"ch460",-87.669154,41.983593,3609,4010,401,7619,60660,5,59,18.9094637069886,91,854.799987591596,0
"ch461",-87.660274,41.984045,3779,3865,86,7644,60626,5.25,62,39.1949130498529,68,133.166721603562,2
"ch462",-87.675815,41.97977,2045,2123,78,4168,60660,5,59,127.786266398844,15,1434.89082367102,0
"ch463",-87.668047,41.977997,6626,6951,325,13577,60660,5,59,19.3925340523446,110,777.326347650239,0
"ch464",-87.679459,41.975615,3824,3803,-21,7627,60625,5.25,62,20.9739243520696,18,1038.42417727193,0
"ch465",-87.650154,41.9716,5211,5282,71,10493,60640,5.26666666666667,61.2666666666667,398.079651831801,30,724.122172053213,0
"ch466",-87.682913,42.012132,459,520,61,979,60645,5.375,63.6875,19.4513556547395,4,1132.09752431037,0
"ch467",-87.690492,42.008594,857,970,113,1827,60645,5.375,63.6875,6.09014104283281,20,1864.81104465607,0
"ch468",-87.696423,41.983665,665,687,22,1352,60645,5.375,63.6875,46.4389909670217,39,1958.81312108301,0
"ch469",-87.716115,41.980394,1003,944,-59,1947,60659,5.5,63.6666666666667,95.8391300205557,21,1410.47142941343,0
"ch47",-87.6277,41.88918,18372,19755,1383,38127,60601,5.94736842105263,68.2105263157895,16.8411782044643,725,277.294522243189,8
"ch470",-87.709261,41.975672,859,873,14,1732,60645,5.375,63.6875,34.4341499129081,32,918.932911377573,0
"ch471",-87.701419,41.975633,1939,1864,-75,3803,60625,5.25,62,162.340152038548,8,1065.01744710024,0
"ch472",-87.692503,41.974911,1672,1585,-87,3257,60625,5.25,62,36.981797693435,46,985.922482661485,0
"ch474",-87.711831,41.968354,1595,1720,125,3315,60625,5.25,62,19.5395505852549,136,113.994292965652,4
"ch475",-87.69617,41.968711,1469,1494,25,2963,60625,5.25,62,7.56644307224932,50,335.537240234307,2
"ch476",-87.708052,41.966686,1111,1125,14,2236,60625,5.25,62,19.5993975519293,129,99.6856772315809,4
"ch477",-87.701083,41.966318,1134,1323,189,2457,60625,5.25,62,20.4804011059165,35,55.4559362785239,2
"ch478",-87.693638,41.9659,2662,2778,116,5440,60625,5.25,62,21.6937536790101,75,45.1328687846775,4
"ch479",-87.716569,41.961154,1244,1194,-50,2438,60625,5.25,62,32.0156498727118,36,803.730994236226,0
"ch48",-87.642884,41.897764,16554,17392,838,33946,60654,5.86666666666667,68.1333333333333,30.3198036125106,58,827.691015150628,0
"ch480",-87.707017,41.9615155,1015,1131,116,2146,60625,5.25,62,29.2008586045164,67,519.644723553811,0
"ch481",-87.695439,41.961068,1526,1569,43,3095,60625,5.25,62,107.404154980165,9,571.467160516578,0
"ch482",-87.691165,41.961526,2299,2310,11,4609,60618,5.4,63.3333333333333,88.5736087066963,22,560.359946881926,0
"ch483",-87.732286,41.9536255,1028,893,-135,1921,60641,5.82352941176471,67.1176470588235,15.407982148378,29,265.133485991218,2
"ch484",-87.719128,41.954005,1204,1176,-28,2380,60618,5.4,63.3333333333333,20.3505868298595,41,846.032558095188,0
"ch485",-87.709311,41.953586,1076,1174,98,2250,60625,5.25,62,49.5459904223398,47,1379.00821216407,0
"ch486",-87.68608,41.954341,1784,1848,64,3632,60625,5.25,62,34.967785874856,16,929.800168897837,0
"ch487",-87.698051,41.952162,1211,1438,227,2649,60625,5.25,62,193.427782102671,45,1570.63516424885,0
"ch488",-87.727737,41.945636,353,371,18,724,60641,5.82352941176471,67.1176470588235,58.9457956603446,32,819.003281580195,0
"ch489",-87.716422,41.946782,1479,1256,-223,2735,60618,5.4,63.3333333333333,85.872982724351,14,1018.1385454143,0
"ch49",-87.629521,41.88132,22616,23220,604,45836,60602,5.94736842105263,68.2105263157895,31.6921159923944,701,69.5511263387459,18
"ch490",-87.70665,41.945244,2230,2247,17,4477,60625,5.25,62,61.9954799662322,32,920.948454307066,0
"ch491",-87.694615,41.946636,1949,2090,141,4039,60618,5.4,63.3333333333333,92.1310074591978,10,1656.72727938741,0
"ch492",-87.683367,41.947029,1714,1840,126,3554,60625,5.25,62,387.377571105755,59,723.472115023851,0
"ch493",-87.687395,41.943026,2958,3166,208,6124,60618,5.4,63.3333333333333,108.374052180684,57,1147.12954331338,0
"ch494",-87.708923,41.982397,733,676,-57,1409,60645,5.375,63.6875,21.3953249923606,35,1646.3032182493,0
"ch495",-87.72897,41.961108,620,613,-7,1233,60625,5.25,62,45.889293818715,58,909.159460656584,0
"ch496",-87.723554,41.939448,1187,1251,64,2438,60647,5.1875,60.125,74.8341289315854,80,939.839007658098,0
"ch497",-87.711561,41.939398,2022,2069,47,4091,60618,5.4,63.3333333333333,22.8175614122236,15,155.411643119883,2
"ch498",-87.698008,41.938429,1601,1662,61,3263,60618,5.4,63.3333333333333,57.6123964237243,43,1190.59663815106,0
"ch499",-87.723777,41.930585,1501,1608,107,3109,60647,5.1875,60.125,153.664490862706,22,1264.68053067277,0
"ch5",-87.627716,41.874053,8123,8335,212,16458,60605,5.61111111111111,64.7222222222222,56.5097878538661,261,19.7356598309899,10
"ch50",-87.630585,41.875933,12340,11041,-1299,23381,60602,5.94736842105263,68.2105263157895,49.542045935822,374,102.722767333742,12
"ch500",-87.716889,41.935337,944,984,40,1928,60647,5.1875,60.125,34.106184713174,58,487.356690444633,2
"ch501",-87.701195,41.931902,2439,2729,290,5168,60625,5.25,62,17.5778872630069,34,655.385915486486,0
"ch502",-87.697899,41.926618,2430,2343,-87,4773,60625,5.25,62,28.580821316657,86,526.401207782969,0
"ch503",-87.715441,41.924399,2242,2481,239,4723,60647,5.1875,60.125,38.3523371951012,56,823.347509547533,0
"ch504",-87.689307,41.924632,3034,3267,233,6301,60625,5.25,62,49.2105912714428,44,696.509780204869,0
"ch505",-87.67646,41.924091,2130,2232,102,4362,60647,5.1875,60.125,93.7712114937396,35,1262.84223486277,0
"ch506",-87.710357,41.917184,2592,2849,257,5441,60647,5.1875,60.125,7.30709262308834,43,1235.7079581851,0
"ch507",-87.701809,41.917513,4192,4132,-60,8324,60625,5.25,62,49.8562820436272,66,638.891696400154,0
"ch508",-87.716632,41.909657,951,1069,118,2020,60647,5.1875,60.125,27.0617593814423,23,2131.51648552084,0
"ch509",-87.70528,41.909769,2461,2344,-117,4805,60647,5.1875,60.125,155.407649166068,22,1520.4171133134,0
"ch51",-87.63189,41.884576,13414,13854,440,27268,60602,5.94736842105263,68.2105263157895,61.5021229637025,654,153.535511087924,12
"ch510",-87.70922,41.902707,1091,1002,-89,2093,60622,6.125,69.9375,406.543818943452,2,2057.93534282428,0
"ch511",-87.705126,41.914027,4724,4612,-112,9336,60647,5.1875,60.125,253.933681164187,37,1113.1474800773,0
"ch514",-87.68452,42.019276,202,193,-9,395,60645,5.375,63.6875,15.7388744853567,29,963.390002975351,0
"ch515",-87.673573,42.019159,827,878,51,1705,60626,5.25,62,4.94851905527719,47,57.4035435965235,4
"ch517",-87.675005,42.015963,392,392,0,784,60645,5.375,63.6875,28.2338276467133,67,386.254332957009,6
"ch518",-87.716866,41.885502,327,346,19,673,60644,5.4375,63.9375,261.456121975829,5,72.2644858688589,2
"ch519",-87.677725,42.016977,214,183,-31,397,60626,5.25,62,232.740976151748,43,462.524149130439,4
"ch52",-87.624117,41.886024,23721,24783,1062,48504,60601,5.94736842105263,68.2105263157895,42.1080695430264,507,335.136870574381,2
"ch520",-87.66857,42.015962,1180,1116,-64,2296,60645,5.375,63.6875,14.7047092856198,30,44.2799339056899,6
"ch522",-87.669563,42.019537,251,262,11,513,60626,5.25,62,38.7819159554251,40,280.708373688299,6
"ch523",-87.665086,42.021019,1135,1134,-1,2269,60626,5.25,62,237.235945312375,5,660.622906595093,0
"ch524",-87.774704,41.894887,87,79,-8,166,60651,5.86666666666667,68.1333333333333,32.9462925931085,11,844.795310492259,0
"ch525",-87.666058,42.012701,339,347,8,686,60645,5.375,63.6875,167.692667846933,21,433.043029630278,4
"ch526",-87.688243,42.012342,209,235,26,444,60645,5.375,63.6875,153.821017868439,23,1474.47863039924,0
"ch527",-87.690048,42.018901,187,199,12,386,60645,5.375,63.6875,39.2767481780042,17,1370.47200890412,0
"ch528",-87.726491,41.885409,76,91,15,167,60644,5.4375,63.9375,46.7547897624764,8,90.2207862923152,2
"ch529",-87.745261,41.886841,64,51,-13,115,60644,5.4375,63.9375,14.7325332478106,11,58.8438623714723,2
"ch53",-87.633775,41.894729,13545,13638,93,27183,60611,5.82352941176471,67.2352941176471,22.5460910831083,316,512.264847549525,0
"ch530",-87.755527,41.887832,47,55,8,102,60302,6.71428571428571,72.75,84.4371403299644,9,86.8192191070855,2
"ch531",-87.765469,41.887664,39,42,3,81,60651,5.86666666666667,68.1333333333333,62.0202281814381,12,34.0388186656955,2
"ch532",-87.774446,41.887919,223,213,-10,436,60302,6.71428571428571,72.75,27.5541527043244,5,74.1670065891735,2
"ch533",-87.71547,41.875679,62,56,-6,118,60644,5.4375,63.9375,123.530797101505,6,796.791592671429,0
"ch534",-87.726279,41.880827,113,126,13,239,60644,5.4375,63.9375,41.8781171137368,39,514.413287999623,0
"ch535",-87.725704,41.874325,106,115,9,221,60652,5.86666666666667,68.1333333333333,114.422209831374,15,58.7440853989447,2
"ch536",-87.73541,41.885928,51,74,23,125,60651,5.86666666666667,68.1333333333333,81.7701771556396,2,773.676929136063,0
"ch537",-87.741018,41.880708,59,42,-17,101,60644,5.4375,63.9375,183.477394008593,22,714.060078379517,0
"ch538",-87.746619,41.872131,23,17,-6,40,60644,5.4375,63.9375,132.166415708647,18,136.450648181366,2
"ch539",-87.745405,41.877613,51,54,3,105,60644,5.4375,63.9375,37.4205906311864,21,671.080408047399,0
"ch54",-87.654061,41.896362,7956,8270,314,16226,60642,5.82352941176471,67.1176470588235,60.2315086884832,25,100.852443442777,2
"ch540",-87.753933,41.88051,61,54,-7,115,60644,5.4375,63.9375,28.2516575929157,29,744.10626116797,0
"ch541",-87.764499,41.872993,31,42,11,73,60804,5.92307692307692,66.6923076923077,259.218543656953,2,1049.50661213157,0
"ch542",-87.763238,41.880121,57,50,-7,107,60302,6.71428571428571,72.75,106.068443579608,24,831.718279819275,0
"ch543",-87.755285,41.875806,32,34,2,66,60644,5.4375,63.9375,27.9357770343493,3,963.463287485396,0
"ch544",-87.773264,41.87998,142,115,-27,257,60644,5.4375,63.9375,52.3943789485225,7,815.473286873211,0
"ch545",-87.735737,41.877917,100,100,0,200,60644,5.4375,63.9375,286.785948605704,18,953.277311845328,0
"ch546",-87.676597,41.823192,75,85,10,160,60609,5.3125,61.0625,362.956588258792,2,761.628988489838,0
"ch547",-87.665577,41.823465,124,139,15,263,60620,5.64285714285714,64.7857142857143,50.5188933917404,9,1410.62708214951,0
"ch548",-87.650931,41.823613,36,22,-14,58,60616,5.82352941176471,67.1764705882353,12.5602777098053,4,1884.41206873706,0
"ch549",-87.666589,41.813996,17,23,6,40,60609,5.3125,61.0625,115.949390796439,36,1788.71976870583,0
"ch55",-87.648625,41.867324,4010,3811,-199,7821,60607,5.33333333333333,62.2777777777778,118.850348520471,59,909.672611514744,0
"ch550",-87.764902,41.894958,29,31,2,60,60651,5.86666666666667,68.1333333333333,23.2975815968196,14,842.986517695625,0
"ch551",-87.67718,41.808227,46,51,5,97,60609,5.3125,61.0625,21.1788225432355,31,700.111142993999,0
"ch552",-87.66454,41.80887,122,40,-82,162,60609,5.3125,61.0625,137.079938339336,32,1688.46795049781,0
"ch553",-87.656526,41.80839,25,14,-11,39,60609,5.3125,61.0625,35.7407052812571,9,2136.89208617716,0
"ch554",-87.674684,41.800908,88,105,17,193,60609,5.3125,61.0625,49.1910746953301,6,874.718592073562,0
"ch555",-87.664699,41.803023,33,28,-5,61,60609,5.3125,61.0625,9.62898434149143,14,1614.47109623488,0
"ch556",-87.657195,41.799659,28,23,-5,51,60609,5.3125,61.0625,246.416923949777,15,2294.3919140325,0
"ch557",-87.674254,41.794587,7,6,-1,13,60609,5.3125,61.0625,64.4670727603556,8,1371.93086763228,0
"ch558",-87.664429,41.792822,12,12,0,24,60609,5.3125,61.0625,69.5081100529942,9,2084.83695166334,0
"ch559",-87.654947,41.794694,22,25,3,47,60636,5.75,65.8125,290.009341347837,6,1962.6897711588,0
"ch56",-87.644448,41.888716,19976,17486,-2490,37462,60606,5.61111111111111,64.7222222222222,50.5719794900006,146,378.058946988717,4
"ch560",-87.666215,41.786833,31,27,-4,58,60636,5.75,65.8125,97.0771801732302,10,2025.83902607229,0
"ch561",-87.674101,41.783681,17,17,0,34,60636,5.75,65.8125,453.438536845234,6,2459.71318794926,0
"ch562",-87.654372,41.783189,1,1,0,2,60620,5.64285714285714,64.7857142857143,42.2519859562923,18,965.059849922257,0
"ch563",-87.664843,41.779374,26,29,3,55,60636,5.75,65.8125,55.1141420104923,22,1713.20000256514,0
"ch564",-87.654308,41.775393,8,8,0,16,60636,5.75,65.8125,349.997510149372,16,924.963020441922,0
"ch565",-87.663815,41.774074,16,14,-2,30,60636,5.75,65.8125,111.061781205847,9,1714.64943381668,0
"ch566",-87.664069,41.768726,20,24,4,44,60636,5.75,65.8125,2.7473295867223,25,2001.17664760359,0
"ch567",-87.652934,41.768938,11,15,4,26,60620,5.64285714285714,64.7857142857143,61.1384750111766,12,1325.47835222773,0
"ch568",-87.637297,41.763462,12,17,5,29,60621,6.125,69.9375,284.0505766638,1,1105.84484649157,0
"ch569",-87.595751,41.75916,11,8,-3,19,60619,5.35714285714286,62.5714285714286,408.183481499618,4,2494.77077527417,0
"ch57",-87.641088,41.867118,6853,7523,670,14376,60605,5.61111111111111,64.7222222222222,36.7341036905026,55,935.366933868977,0
"ch570",-87.606685,41.758308,22,20,-2,42,60649,5.21428571428571,60.7142857142857,44.9906570123155,20,1765.35122946705,0
"ch571",-87.614138,41.758361,9,12,3,21,60619,5.35714285714286,62.5714285714286,20.1916354991018,28,1269.29832324763,0
"ch572",-87.624621,41.756971,42,59,17,101,60621,6.125,69.9375,184.762039083624,18,728.865699343302,0
"ch573",-87.624424,41.750794,103,90,-13,193,60619,5.35714285714286,62.5714285714286,24.0177324996588,27,70.7763386842399,2
"ch574",-87.613783,41.750951,25,38,13,63,60619,5.35714285714286,62.5714285714286,28.8796448972152,36,944.122039642832,0
"ch575",-87.605026,41.753174,25,34,9,59,60619,5.35714285714286,62.5714285714286,183.060971213068,34,1698.3840750741,0
"ch576",-87.597552,41.751294,18,15,-3,33,60619,5.35714285714286,62.5714285714286,185.252633422338,9,2294.31140710745,0
"ch577",-87.585337,41.751173,39,48,9,87,60649,5.21428571428571,60.7142857142857,37.673572730969,18,3309.27514847347,0
"ch578",-87.574845,41.751802,28,27,-1,55,60617,5.21428571428571,61.3571428571429,81.3967847146028,12,4083.50873259369,0
"ch579",-87.565211,41.75182,29,23,-6,52,60649,5.21428571428571,60.7142857142857,21.1225448605615,14,4629.88528523136,0
"ch58",-87.668879,41.916017,16914,16796,-118,33710,60614,5.82352941176471,67.2352941176471,61.7835382388167,20,994.770285496579,0
"ch580",-87.552812,41.751731,16,15,-1,31,NA,5.65194094747947,65.2719986419663,19.5260098905223,5,5434.23666631257,0
"ch581",-87.551201,41.744607,11,10,-1,21,60617,5.21428571428571,61.3571428571429,70.6627499078898,8,6031.75430286197,0
"ch582",-87.564725,41.746334,2,8,6,10,60617,5.21428571428571,61.3571428571429,301.103569121854,1,5043.22125708666,0
"ch583",-87.586005,41.746559,50,33,-17,83,60619,5.35714285714286,62.5714285714286,31.7790554219368,12,3280.90390311682,0
"ch584",-87.599034,41.744123,7,7,0,14,60619,5.35714285714286,62.5714285714286,487.984977972625,7,2279.04383467274,0
"ch585",-87.604786,41.744053,152,147,-5,299,60619,5.35714285714286,62.5714285714286,27.9045578627095,26,1832.56904585906,0
"ch586",-87.6148,41.743116,17,30,13,47,60619,5.35714285714286,62.5714285714286,52.3934488710727,5,1180.5281253007,0
"ch587",-87.622849,41.743316,9,9,0,18,60619,5.35714285714286,62.5714285714286,29.3205391431954,4,811.063555833377,0
"ch588",-87.575225,41.743921,7,8,1,15,60617,5.21428571428571,61.3571428571429,28.9168847708489,6,4211.79350151265,0
"ch589",-87.749594,41.954468,224,222,-2,446,60630,4.8125,57.0625,32.3968364736972,58,930.555240627071,0
"ch59",-87.625961,41.867227,21587,22944,1357,44531,60605,5.61111111111111,64.7222222222222,10.4679075528055,123,55.8384709430218,4
"ch590",-87.740569,41.953733,265,228,-37,493,60641,5.82352941176471,67.1176470588235,76.8371576819201,11,902.114408043984,0
"ch591",-87.74002,41.948818,113,127,14,240,60641,5.82352941176471,67.1176470588235,436.207678065184,3,1004.30892345935,0
"ch592",-87.745359,41.960631,312,231,-81,543,60641,5.82352941176471,67.1176470588235,222.918198147655,10,179.078726218133,2
"ch593",-87.644874,41.787539,11,5,-6,16,60621,6.125,69.9375,68.5133633291838,8,956.185153560303,0
"ch594",-87.683392,41.805661,152,137,-15,289,60609,5.3125,61.0625,327.794037122682,15,134.35758556301,2
"ch595",-87.622634,41.736646,22,43,21,65,60619,5.35714285714286,62.5714285714286,37.9383254564706,17,223.722532898785,2
"ch596",-87.683485,42.048214,2620,2519,-101,5139,60208,6.225,69.3,3166.94939788392,0,745.028897244949,0
"ch597",-87.679101,42.032562,1348,1350,2,2698,60202,6.59523809523809,72.4523809523809,1401.86727715583,0,105.688274083674,2
"ch598",-87.684107,42.025784,172,224,52,396,60626,5.25,62,707.973761156603,0,519.807389187665,0
"ch599",-87.699413,42.039742,185,202,17,387,60202,6.59523809523809,72.4523809523809,2278.34775407927,0,1489.94357055512,0
"ch6",-87.61279477,41.885041995,20368,18213,-2155,38581,60601,5.94736842105263,68.2105263157895,79.5719290567726,11,1246.77967135086,0
"ch60",-87.649422,41.910578,10762,10796,34,21558,60614,5.82352941176471,67.2352941176471,37.4709837579369,112,22.0527767742571,2
"ch600",-87.698224,42.048308,447,457,10,904,60201,6.59523809523809,72.4523809523809,3228.06081566503,0,1562.03196233153,0
"ch601",-87.69873,42.063598,685,695,10,1380,60201,6.59523809523809,72.4523809523809,4926.48598852412,0,1086.19598889651,0
"ch602",-87.685962,42.063999,705,654,-51,1359,60201,6.59523809523809,72.4523809523809,4917.12781539649,0,28.5859481299116,2
"ch603",-87.677821,42.050491,1484,1360,-124,2844,60208,6.225,69.3,3321.7013929605,0,978.458238121367,0
"ch604",-87.677432,42.058239,1493,1503,10,2996,60208,6.225,69.3,4174.21063327532,0,488.810563585108,2
"ch605",-87.673447,42.052939,1294,1330,36,2624,60208,6.225,69.3,3569.11860720706,0,1011.15988737694,0
"ch606",-87.800367,41.894071,902,775,-127,1677,60302,6.71428571428571,72.75,1665.06868670753,0,835.452123867497,0
"ch607",-87.783055,41.898168,482,521,39,1003,60302,6.71428571428571,72.75,788.582295459488,0,1223.81662822766,0
"ch608",-87.776842,41.890491,146,115,-31,261,60302,6.71428571428571,72.75,326.728083895189,10,420.292830745506,2
"ch609",-87.800255,41.88891,663,702,39,1365,60302,6.71428571428571,72.75,2118.17976268512,0,333.507290506329,2
"ch61",-87.672552,41.907655,11275,11815,540,23090,60622,6.125,69.9375,18.6793887917698,220,467.020879218523,2
"ch610",-87.80287,41.88681,1198,1256,58,2454,60153,6.65217391304348,72.7173913043478,2336.49941019718,0,25.7455303329841,2
"ch611",-87.793899,41.886923,815,860,45,1675,60302,6.71428571428571,72.75,1592.67796884732,0,12.033916158185,2
"ch612",-87.785236,41.888085,456,462,6,918,60302,6.71428571428571,72.75,869.289268529792,0,166.331097526088,2
"ch613",-87.80224,41.879837,696,678,-18,1374,60153,6.65217391304348,72.7173913043478,2295.87071916649,0,782.584723460256,0
"ch614",-87.789247,41.880113,651,600,-51,1251,60302,6.71428571428571,72.75,1217.40527526313,0,851.383624300712,0
"ch615",-87.779425,41.87981,312,417,105,729,60304,6.71428571428571,72.75,402.4604127488,3,888.763856662115,0
"ch616",-87.793945,41.872987,483,488,5,971,60402,6.59090909090909,72.0909090909091,1785.09985344498,0,217.633928463088,2
"ch617",-87.788938,41.871312,512,532,20,1044,60402,6.59090909090909,72.0909090909091,1407.57339016402,0,238.174832809006,2
"ch618",-87.77919,41.87055,506,396,-110,902,60304,6.71428571428571,72.75,710.117390750902,0,200.228294353228,2
"ch619",-87.727752,41.924361,541,530,-11,1071,60639,5.06666666666667,59.2,128.691403876891,20,1701.31882742386,0
"ch62",-87.618835,41.851375,6208,5914,-294,12122,60616,5.82352941176471,67.1764705882353,19.49809048309,68,657.428129714528,0
"ch620",-87.637536,41.898203,593,392,-201,985,60654,5.86666666666667,68.1333333333333,12.9440100850982,153,795.147727024191,0
"ch66",-87.641253,41.885464,21872,21343,-529,43215,60602,5.94736842105263,68.2105263157895,32.8852471457108,339,49.9274952827049,2
"ch67",-87.653708,41.925602,15534,16326,792,31860,60614,5.82352941176471,67.2352941176471,66.4912913242534,149,92.8622306003558,4
"ch68",-87.640795,41.875885,6940,6870,-70,13810,60402,6.59090909090909,72.0909090909091,85.0235944500128,133,41.5097198516727,2
"ch69",-87.677692,41.909396,19423,20905,1482,40328,60647,5.1875,60.125,9.64471075580206,237,44.0642428491604,2
"ch7",-87.617517,41.886349,10088,9398,-690,19486,60601,5.94736842105263,68.2105263157895,32.750343035147,114,871.508529144227,0
"ch71",-87.652305,41.885483,13977,14794,817,28771,60622,6.125,69.9375,2.48419642412594,300,14.7409158439455,2
"ch72",-87.625813,41.860384,8500,9556,1056,18056,60605,5.61111111111111,64.7222222222222,132.963705720204,40,782.49083802069,0
"ch73",-87.642746,41.880422,11060,10116,-944,21176,60402,6.59090909090909,72.0909090909091,75.3431721842641,365,561.734848939161,0
"ch74",-87.641711,41.893882,19795,18271,-1524,38066,60654,5.86666666666667,68.1333333333333,59.1423690826798,72,571.439925924828,0
"ch75",-87.641052,41.878412,30503,29066,-1437,59569,60602,5.94736842105263,68.2105263157895,62.595553960965,259,319.156602801098,2
"ch76",-87.616743,41.880958,51090,48583,-2507,99673,60601,5.94736842105263,68.2105263157895,45.4078269175607,13,788.111682263089,0
"ch77",-87.641066,41.882242,41744,35433,-6311,77177,60602,5.94736842105263,68.2105263157895,35.2141708995069,409,386.239458017438,2
"ch80",-87.653929,41.880456,10577,11047,470,21624,60607,5.33333333333333,62.2777777777778,12.8453028719664,120,587.731278366677,0
"ch81",-87.629634,41.884241,23240,22895,-345,46135,60601,5.94736842105263,68.2105263157895,29.6190828579313,730,120.702377629301,14
"ch84",-87.645925,41.891,9293,8160,-1133,17453,60654,5.86666666666667,68.1333333333333,83.0838698117334,39,138.782440720851,2
"ch85",-87.623777,41.90096,37754,39710,1956,77464,60611,5.82352941176471,67.2352941176471,21.5037969458879,262,600.162312925973,0
"ch86",-87.660984,41.896373,5982,5899,-83,11881,60622,6.125,69.9375,49.346564202605,52,479.967481853029,2
"ch87",-87.658404,41.925563,7436,7515,79,14951,60614,5.82352941176471,67.2352941176471,67.30629013291,51,462.870465302518,4
"ch88",-87.655688,41.88397,6906,6999,93,13905,60622,6.125,69.9375,59.7126626419477,197,341.125155941207,2
"ch89",-87.633106,41.875009,9549,8626,-923,18175,60602,5.94736842105263,68.2105263157895,67.5853032193543,272,130.592859806445,10
"ch9",-87.680604,41.828792,859,838,-21,1697,60609,5.3125,61.0625,87.5119023643264,38,62.3281899460028,2
"ch90",-87.624084,41.881032,37453,40071,2618,77524,60601,5.94736842105263,68.2105263157895,50.633715768729,416,234.457860831367,8
"ch91",-87.64117,41.88338,47125,43924,-3201,91049,60602,5.94736842105263,68.2105263157895,34.7679015468568,375,260.246719473965,2
"ch92",-87.653449,41.894556,6216,5609,-607,11825,60642,5.82352941176471,67.1176470588235,85.1322539897472,47,223.426195987617,2
"ch93",-87.652855,41.913688,8898,8752,-146,17650,60622,6.125,69.9375,7.25718430663297,89,454.53374010361,2
"ch94",-87.636282,41.918306,21582,22651,1069,44233,60614,5.82352941176471,67.2352941176471,118.605579784245,61,912.213865574755,0
"ch95",-87.586788,41.778701,468,406,-62,874,60649,5.21428571428571,60.7142857142857,240.203016240726,4,1595.3520710245,0
"ch96",-87.644571,41.884616,9955,8911,-1044,18866,60606,5.61111111111111,64.7222222222222,19.4315864517895,396,259.806945440526,2
"ch97",-87.617813,41.865262,14850,13451,-1399,28301,60605,5.61111111111111,64.7222222222222,162.679458532911,21,766.590351188624,0
"ch98",-87.63253,41.882664,15224,13767,-1457,28991,60602,5.94736842105263,68.2105263157895,3.40845114571133,622,103.810582772429,16
"ch99",-87.614492,41.89257,16185,15800,-385,31985,60601,5.94736842105263,68.2105263157895,146.868122751196,160,1127.26987012585,0
